integral: [数学]积分, 完整, 部分 (作答错误)
momentum: 动力, 要素 (作答错误)
attract: 有吸引力, 引起注意 (未作答)
turnover: 翻覆, 翻折, 半圆卷饼, 流通量, 营业额, 周转 (作答错误)
gauge: 测量 (作答错误)
protest: 主张, 断言, 抗议 (作答错误)
purify: 净化 (作答错误)
electric: 电的, 导电的, 电动的, 电气 (作答错误)
owe: 欠, 应感激, 应该把…归功于(to) (作答错误)
outfit: 得到装备 (未作答)
recognize: 认可, 承认, 公认, 赏识 (未作答)
presentation: 提供显示外观 (作答错误)
expansion: 扩充, 开展, 膨胀, 扩张物, 辽阔, 浩瀚 (未作答)
barricade: 路障 (作答错误)
expert: 老练的, 内行的, 专门的 (作答错误)
resultant: 作为结果而发生的, 合成的 (作答错误)
irrigation: 灌溉, 冲洗 (作答错误)
recall: 回忆, 回想, 记起, 取消 (作答错误)
proof: 证据, 试验, 考验, [印刷]校样 (作答错误)
religious: 信奉宗教的, 虔诚的, 宗教上的, 修道的, 严谨的 (作答错误)
subtle: 狡猾的, 敏感的, 微妙的, 精细的, 稀薄的 (未作答)
drain: 排出沟外, 喝干, 耗尽 (未作答)
ascribe: 归因于, 归咎于 (未作答)
superiority: 优越, 高傲 (未作答)
reverse: 颠倒, 倒转 (作答错误)
peculiar: 特有财产, 特权 (作答错误)
glitter: 闪闪发光, 闪烁, 闪光 (未作答)
update: 现代化, 更新 (作答错误)
barricade: 设路障 (作答错误)
characteristic: 特性, 特征 (作答错误)
access: 存取, 接近 (作答错误)
dine: 吃饭, 进餐 (作答错误)
canvas: 帆布 (作答错误)
mortal: 凡人, 人类 (作答错误)
gracious: 亲切的, 和谐的, 优美的, 雅致的, 雍容华贵的 (作答错误)
tangle: 处于混乱状态 (作答错误)
erect: 直立的, 竖立的, 笔直的 (作答错误)
handicap: 障碍, 阻碍, 障碍赛跑 (未作答)
apt: 易于...的, 有...倾向的, 灵敏的, 灵巧的, 适当的, 切题的, 敏捷, 倾向是 (作答错误)
intensify: 加强 (未作答)
jury: [律]陪审团, 评判委员会, 陪审员 (作答错误)
clip: 夹住, 剪短, 修剪 (作答错误)
nickname: 给...取绰号, 给...起浑名 (作答错误)
formidable: 强大的, 令人敬畏的, 可怕的, 艰难的 (作答错误)
shield: 遮蔽 (作答错误)
gauge: 测量 (作答错误)
concede: 让步 (作答错误)
allocate: 分派, 分配 (作答错误)
convict: 罪犯 (作答错误)
dart: 标枪, 镖, (昆虫的)刺, 飞快的动作 (作答错误)
vice: 代替 (作答错误)
counter: 计算器, 计数器, 计算者, 柜台, 筹码 (作答错误)
yield: 出产, 生长, 生产 (作答错误)
integral: 完整的, 整体的, [数学]积分的, 构成整体所需要的 (作答错误)
modify: 更改, 修改 (未作答)
institute: 创立, 开始, 制定, 开始(调查), 提起(诉讼) (作答错误)
respond: 回答, 响应, 作出反应 (未作答)
aesthetic: 美学的, 审美的, 有审美感的 (未作答)
account: 说明, 总计有, 认为, 得分 (未作答)
bounce: (使)反跳, 弹起, (指支票)被银行退票, 弹跳 (未作答)
mute: 排泄 (作答错误)
aggregate: 聚集, 集合, 合计 (作答错误)
analogy: 类似, 类推 (作答错误)
ancestor: 祖先, 祖宗 (未作答)
scrape: 刮掉, 擦掉, 刮出刺耳声 (未作答)
witness: 作证, 成为证据 (未作答)
mobilize: 动员 (未作答)
derive: 起源 (未作答)
concentration: 集中, 集合, 专心, 浓缩, 浓度 (未作答)
confidential: 秘密的, 机密的 (未作答)
